

sexocean.com - free,sex,xxx,porno,youngest





























 


sex ocean®
visit us each 1/2 hour and get new hardcore galleries!click here for modern sexocean v.2 video version  - built especially for all funs of sexocean classic v.1 pics which is still available for you since 1999. thank you ladies  & gentlemens for 26 years of your loyality. -sincerely yours, webmaster =)


 





bookmark us!
( if you are using firefox or chrome broswer - press ctr+d )





 



today's best galleries :



16 images
16 images
15 images new!
16 images new!
16 images
16 images



15 images
15 images
16 images
16 images
15 images
16 images



16 images
16 images
16 images
16 images



15 images
16 images
16 images
16 images



16 images
16 images
16 images
16 images




and more ...



16 images
15 images
16 images
15 images
16 images
15 images



16 images
15 images
16 images
15 images
16 images
15 images



16 images
16 images
16 images
16 images



16 images
16 images
16 images new!
16 images



16 images
16 images
16 images
16 images new!




and more ...



16 images new!
16 images new!
16 images
16 images
16 images
15 images



15 images
15 images
16 images
15 images
16 images
16 images



16 images
16 images
16 images
16 images



15 images
16 images
16 images
15 images



16 images
16 images
16 images
16 images




and more ...



16 images
16 images
15 images
16 images new!
16 images
15 images



16 images
16 images
15 images
15 images
15 images
15 images



15 images
16 images
16 images new!
16 images



16 images
16 images
16 images
16 images



15 images
16 images
16 images
16 images




and more ...



15 images
15 images
16 images
16 images
16 images
15 images



15 images
16 images
15 images
15 images
15 images
16 images



16 images new!
16 images
16 images
16 images



16 images
16 images
16 images
16 images



16 images
15 images
16 images
16 images






we guarantee, you've never seen this movies before:









the rest of db sorted in 296 categories alphabetically: new!!!





action: images ~ action movies
aged: images  ~ aged movies 
amateur: images  ~ amateur movies 
amazing: images  ~ amazing movies 
american: images  ~ american movies 
anal: images  ~ anal movies 
angel: images  ~ angel movies 
anime: images  ~ anime movies 
asian: images  ~ images  ~ ass movies 
asshole: images  ~ asshole movies 

bbw: images  ~ bbw movies 
bdsm: images  ~ bdsm movies 
babe: images  ~ babe movies 
backseat: images  ~ backseat movies 
banana: images  ~ banana movies 
bang: images  ~ bang movies 
banged: images  ~ banged movies 
banging: images  ~ banging movies 
barely: images  ~ barely movies 
bath: images  ~ bath movies 
bathing: images  ~ bathing movies 
bathroom: images  ~ bathroom movies 
beach: images  ~ beach movies 
beautiful: images  ~ beautiful movies 
beauty: images  ~ beauty movies 
beaver: images  ~ beaver movies 
bed: images  ~ bed movies 
bigtit: images  ~ bigttis movies 
bikini: images  ~ bikini movies 
bimbo: images  ~ bimbo movies 
bisexual: images  ~ bisexual movies 
bitch: images  ~ bitch movies 
bizarre: images  ~ bizzare movies 
black: images  ~ black movies 
blonde: images  ~ blonde movies 
blowjob: images  ~ blowjob movies 
boat: images  ~ boat movies 
bondage: images  ~ bondage movies 
boob: images  ~ boobs movies 
booty: images  ~ booty movies 
boss: images  ~ boss movies 
boy: images  ~ boy movies 
brunette: images  ~ brunette movies 
bukkake: images  ~ bukkake movies 
busty: images  ~ busty movies 
butt: images  ~ butt movies 

cartoon: images  ~ cartoon movies 
celebrity: images  ~ celebrity movies 
chain: images  ~ chain movies 
chair: images  ~ chair movies 
cheerleader: images  ~ cheerleader movies 
chick: images  ~ chick movies 
chinese: images  ~ chinese movies 
chocolate: images  ~ chocolate movies 
chubby: images  ~ chubby movies 
classy: images  ~ classy movies 
clit: images  ~ clit movies 
cock: images  ~ cock movies 
coed: images  ~ coed movies 
collection: images  ~ collection movies 
college: images  ~ college movies 
comic: images  ~ comic movies 
cop: images  ~ cop movies 
corset: images  ~ corset movies 
cotton: images  ~ cotton movies 
couch: images  ~ coutch movies 
couple: images  ~ couple movies 
cum: images  ~ cum movies 
cumshot: images  ~ cumshot movies 
cunt: images  ~ cunt movies 
curly: images  ~ curly movies 
cute: images  ~ movies 

dick: images  ~ dick movies 
dildo: images  ~ dildo movies 
dirty: images  ~ dirty movies 
doctor: images  ~ doctor movies 
doll: images  ~ doll movies 
domination: images  ~ domination movies 
dorm: images  ~ dorm movies 
double: images  ~ double movies 
dress: images  ~ dress movies 
drilled: images  ~ drilled movies 
drinking: images  ~ drinking movies 
drunk: images  ~ drunk movies 

ebony: images  ~ ebony movies 
ethnic: images  ~ ethic movies 
euro: images  ~ euro movies 
european: images  ~ european movies 
exhibitionist: images  ~ exhibitionist movies 
exotic: images  ~ exotic movies 
experience: images  ~ experience movies 
extreme: images  ~ extreme movies 

ffm: images  ~ ffm movies 
facial: images  ~ facial movies 
fantasy: images  ~ fantasy movies 
fat: images  ~ fat movies 
feet: images  ~ feet movies 
femdom: images  ~ femdom movies 
fetish: images  ~ fetish movies 
finger: images  ~ finger movies 
first: images  ~ first movies 
fist: images  ~ fist movies 
flasher: images  ~ flasher movies 









foot: images  ~ foot movies 
foreplay: images  ~ foreplay movies 
fuck: images  ~ fuck movies 
fucking: images  ~ fucking movies 

gangbang: images  ~ gangbang movies 
gay: images  ~ gay movies 
ghetto: images  ~ ghetto movies 
girl: images  ~ girl movies 
girlfriend: images  ~ girlfriend movies 
glasses: images  ~ glasses movies 
gorgeous: images  ~ gorgeus movies 
goth: images  ~ goth movies 
grandma: images  ~ grandma movies 
granny: images  ~ granny movies 
group: images  ~ group movies 
guy: images  ~ guy movies 
gym: images  ~ gym movies 

hairy: images  ~ hairy movies 
hardcore: images  ~ hardcore movies 
hentai: images  ~ hentai movies 
hidden: images  ~ hidden movies 
hirsute: images  ~ hirsute movies 
hooter: images  ~ hooter movies 
horny: images  ~ horny movies 
hospital: images  ~ hospital movies 
hotel: images  ~ hotel movies 
house: images  ~ house movies 
housewife: images  ~ housewife movies 
huge: images  ~ huge movies 

indian: images  ~ indian movies 
innocent: images  ~ innocent movies 
interracial: images  ~ interracial movies 

japanese: images  ~ japanese movies 
jerking: images  ~ jerking movies 
jizz: images  ~ jizz movies 
juicy: images  ~ juicy movies 

kinky: images  ~ kinky movies 
kissing: images  ~ kissing movies 
kitchen: images  ~ kitechen movies 

lace: images  ~ lace movies 
large: images  ~ large movies 
latex: images  ~ latex movies 
latin: images  ~ latin movies 
leather: images  ~ leather movies 
leg: images  ~ leg movies 
lesbian: images  ~ lesbian movies 
lezzie: images  ~ lezzie movies 
lick: images  ~ lick movies 
lingerie: images  ~ lingerie movies 
little: images  ~ littele movies 
lust: images  ~ lust movies 

milf: images  ~ milf movies 
mmf: images  ~ mmf movies 
machine: images  ~ machine movies 
maid: images  ~ maid movies 
male: images  ~ male movies 
masturbating: images  ~ masturbating movies 
mature: images  ~ mature movies 
melon: images  ~ melon movies 
military: images  ~ military porn movies 
mistress: images  ~ mistress movies 
mom: images  ~ mom porn movies 
monster: images  ~ monster sex movies 
muff: images  ~ muff movies 

naked: images  ~ naked movies 
natural: images  ~ natural movies 
nature: images  ~ nature movies 
naughty: images  ~ naughty movies 
nipple: images  ~ nipple movies 
nude: images  ~ nude movies 
nudist: images  ~ nudist movies 
nurse: images  ~ nurce porn movies 
nylon: images  ~ nylon movies 
nympho: images  ~ nympho movies 

office: images  ~ office movies 
oiled: images  ~ oiled movies 
older: images  ~ older movies 
oral: images  ~ oral movies 
orgasm: images  ~ orgasm movies 
orgies: images  ~ orgies movies 
orgy: images  ~ orgy movies 
oriental: images  ~ oriental movies 
outdoor: images  ~ outdoor porn movies 
outside: images  ~ outside sex movies 

pain: images  ~ pain porn movies 
panties: images  ~ panties movies 
panty: images  ~ panty porn movies 
pantyhose: images  ~ pantyhouse movies 
park: images  ~ park sex movies 
party: images  ~ party porn movies 
pee: images  ~ pee porn movies 
peeing: images  ~ peeing movies 
penetrate: images  ~ penetrate movies 
perfect: images  ~ perfect porn movies 
petite: images  ~ petite movies 
pierce: images  ~ pierce movies 
pigtail: images  ~ pigtail movies 
pink: images  ~ pink porn movies 
piss: images  ~ piss movies 









pissing: images  ~ pissing movies 
plump: images  ~ plump movies 
police: images  ~ police sex movies 
pool: images  ~ pool movies 
pornstar: images  ~ pornstar movies 
poser: images  ~ poser movies 
pregnant: images  ~ pregnant movies 
pretty: images  ~ pretty movies 
private: images  ~ private movies 
public: images  ~ publics sex movies 
pussy: images  ~ pussy movies 

queen: images  ~ queen porn movies 
quick: images  ~ quick sex movies 

redhead: images  ~ redhead movies 
riding: images  ~ riding movies 
rub: images  ~ rub porn movies 
russian: images  ~ russian movies 

schoolgirl: images  ~ schoolgirl movies 
sea: images  ~ sea porn movies 
secretary: images  ~ secretary movies 
series: images  ~ series movies 
sex: images  ~ sex movies 
sexy: images  ~ sexy movies 
shaved: images  ~ shaved movies 
shaving: images  ~ shaving movies 
shemale: images  ~ shemale movies 
shower: images  ~ shower movies 
skinny: images  ~ skinny movies 
skirt: images  ~ skirt movies 
slave: images  ~ slave movies 
slim: images  ~ slim movies 
slut: images  ~ slut movies 
smoke: images  ~ smoke movies 
smoking: images  ~ smoking movies 
sofa: images  ~ sofa movies 
spank: images  ~ spank movies 
sperm: images  ~ sperm movies 
sport: images  ~ sport movies 
spread: images  ~ spread movies 
spreading: images  ~ speading movies 
spy: images  ~ spy porn movies 
stocking: images  ~ stocking movies 
strapon: images  ~ strapon movies 
strip: images  ~ strip movies 
stripper: images  ~ stripper movies 
stud: images  ~ stud movies 
student: images  ~ student movies 
sucking: images  ~ sucking movies 
sweet: images  ~ sweet movies 
sybian: images  ~ sybian movies 

tall: images  ~ tall movies 
tan: images  ~ tan movies 
tattoo: images  ~ tattoo movies 
teacher: images  ~ teacher movies 
tease: images  ~ tease movies 
teen: images  ~ teen porn movies 
thai: images  ~ thai movies 
thong: images  ~ thong movies 
threesome: images  ~ threesome movies 
tied: images  ~ tied movies 
tiny: images  ~ tiny movies 
tit: images  ~ tit movies 
toilet: images  ~ toilet movies 
toon: images  ~ toon movies 
topless: images  ~ topless movies 
torture: images  ~ torture movies 
toy: images  ~ tory movies 
tramp: images  ~ tramp movies 
tranny: images  ~ tranny movies 
transsexual: images  ~ trans movies 
tub: images  ~ tub movies 
twink: images  ~ twink movies 

undressing: images  ~ undressing movies 
uniform: images  ~ uniform movies 
upskirt: images  ~ upskirt movies 

vagina: images  ~ vagina movies 
vibrator: images  ~ vibrator movies 
virgin: images  ~ virgin movies 
vixen: images  ~ vixen movies 
voyeur: images  ~ voyeur porn movies 

water: images  ~ water movies 
watersport: images  ~ watersport movies 
webcam: images  ~ webcam movies 
wet: images  ~ wet movies 
white: images  ~ white movies 
whore: images  ~ whore movies 
wife: images  ~ wife movies 
wild: images  ~ wild porn movies 
wives: images  ~ wives movies 
work: images  ~ work porn movies 

xxx: images  ~ xxx movies 

yacht: images  ~ yacht porn movies 
young: images  ~ young porn  movies 






other good porn links:



comment : once i've searched for a good porn i've found it on this sex videos site,which i strongly recommend you to visit! you will be satisfied for sure!!!





not enough? more porn here! >>> 

webmasters:post your galleries | lets trade traffic

 



all models were at least 18 y.o. at the time of the photography.
all pictures presented by third parties by thier good will. all pictures is legal property of third parties.
the content also provided by third paty. sex ocean is not responsible for it.










